Sequence=[Sequence,Location Id,locationId]
Carrier=[carrierName,Carrier,GeneralLiabilityPolicyQuoteInqRq,Bearer,Conveyor,Transporter]
Rater=[Rater,Valuer,Appraiser,Estimator,Evaluator,Assessor]
BusinessType=[lobType,BusinessType,BusiType,BusiTyp,TypeOfBusi,TypeOfBusiness]
Name=[applicantName,CommercialName,Name,ComName,CommerName,CommonName]
DoingBusinessAs=[DoBusiAs,DoingBusinessAs,DoingBusAs,DoBusinessas]
ForeginAddress=[ForeginAddress]
Address=[Addr]
RetailAgency=[RetailAgency]
EffectiveDate=[effectiveDate,EffectiveDate,EffectiveDt]
ExpirationDate=[expirationDate,ExpirationDate,ExpirationDt]
Id=[agentId,Id,RqUID,ReqUID,UID,Id_No]
DistanceToCoast=[distanceToCoast,DistanceToCoast]
DistanceToCoastOverride=[DistanceToCoastOverride]
Address1=[addressLine1,Addr1,Address1,Add1,first_Address]
Address2=[addressLine2,Addr2,Address2,Add2,second_Address]
City=[city,City,Place,Loc]
State=[state,State,Station]
ZipCode=[PostalCode,PostCode,ZipCode,ZCOde,PCode,zipcode]
County=[County]
Quadrant=[Quadrant]
IsMultipleOccupancy=[IsMultipleOccupancy]
IsonlyGL=[IsonlyGL]
BuildingId=[BuildingId]
OccurenceLimit=[CoverageCd:EAOCC,EAOCC,OccurenceLimit]
AggregateLimit=[CoverageCd:GENAG,GENAG,AggregateLimit]
ProductsCompletedOperationsLimit=[productsAndCompletedOpsAggregateLimit,CoverageCd:PRDCO,PRDCO,ProductsCompletedOperationsLimit]
MedicalExpensesLimit=[CoverageCd:MEDEX,MEDEX,MedicalExpensesLimit]
DamageToPremesisRentedToYouLimit=[DamageToPremesisRentedToYouLimit]
PersonalInjuryAndAdvertisingLimit=[personalAndAdvertisingInjuryLimit,CoverageCd:PIADV,PersonalInjuryAndAdvertisingLimit,PIADV]
PremOpsDeductible=[PremOpsDeductible,premOpsRate]
ProdOpsDeductible=[ProdOpsDeductible,prodOpsRate]
ProfessionalIncidentLimit=[ProfessionalIncidentLimit]
IfAny=[IfAny,IfAnyRatingBasisInd]
AdditionalInsured=[AdditionalInsured]
Deductible=[Deductible,deductible]
Exposure=[Exposure,exposure]
BasisType=[BasisType]
SnowRemoval=[SnowRemoval]
Programs=[Programs]
ClassCode=[ClassCd,classCode,ClassCode]
ClassCodeDescription=[ClassCdDesc,ClCdDesc,ClassCodeDescription]
LocationSequence=[locationRefId,LocationSequence,GeneralLiabilityClassification LocationRef]
AdditionalPremium=[AdditionalPremium]
Premium=[Premium]
CommercialLinesProperty=[CommercialLinesProperty]
PersonalLinesLiability=[PersonalLinesLiability]
PersonalLinesProperty=[PersonalLinesProperty]
InlandMarine=[InlandMarine]
LiquorLiability=[LiquorLiability]
Terrorism=[Terrorism]
Description=[Description]
IsoStateTerritory=[IsoStateTerritory]
Latitude=[Latitude]
Longitude=[Longitude]
MinimumPremiumApplied=[MinimumPremiumApplied]
MinimumPremium=[MinimumPremium]
RatingSource=[RatingSource]
CarrierRateRevisionReferenceNumber=[CarrierRateRevisionReferenceNumber]
CarrierRateVersion=[CarrierRateVersion]
PrimaryState=[PrimaryState]
CarrierRateReferenceURL=[CarrierRateReferenceURL]
CarrierRateReferenceNumber=[CarrierRateReferenceNumber]
TotalPremium=[TotalPremium]
Earthquake=[Earthquake]
Classifications=[Classifications]
ForeignAddress=[ForeignAddress]
ProfessionalLiability=[ProfessionalLiability]
EachCommonCauseLimit=[EachCommonCauseLimit]
MedicalExpensesLimitType=[MedicalExpensesLimitType]
Value=[Value]
TotalYears=[TotalYears]
IsSubContractor=[IsSubContractor]
OwnerPayrollAmt=[OwnerPayrollAmt]
Surcharge=[Surcharge]
PremOpsRate=[PremOpsRate]
ProdOpsAmt=[ProdOpsAmt]
ProdOpsRate=[ProdOpsRate]
PremOpsAmt=[PremOpsAmt]
PremOpsAdjPremium=[PremOpsAdjPremium]
PremOpsBaseRate=[PremOpsBaseRate]
PremOpsDeductibleFactor=[PremOpsDeductibleFactor]
PremOpsFinalModifiedRate=[PremOpsFinalModifiedRate]
PremOpsIlfFactor=[PremOpsIlfFactor]
PremOpsLcmFactor=[PremOpsLcmFactor]
PremOpsModFactor=[PremOpsModFactor]
PremOpsModifiedRate=[PremOpsModifiedRate]
PremOpsRateModFactor=[PremOpsRateModFactor]
ProdOpsAdjPremium=[ProdOpsAdjPremium]
ProdopsBaseRate=[ProdopsBaseRate]
ProdOpsDeductibleFactor=[ProdOpsDeductibleFactor]
ProdOpsFinalModifiedRate=[ProdOpsFinalModifiedRate]
ProdOpsIlfFactor=[ProdOpsIlfFactor]
ProdOpsLcmFactor=[ProdOpsLcmFactor]
ProdOpsModFactor=[ProdOpsModFactor]
ProdOpsModifiedRate=[ProdOpsModifiedRate]
ProdOpsRateModFactor=[ProdOpsRateModFactor]
ModFactor=[ModFactor]
Authority=[Authority]	
Rate=[Rate]
DamageToPremesisRentedToYouLimitType=[DamageToPremesisRentedToYouLimitType]
Coverage=[Coverage]